XXXXXXXXXFXXXXXXX
S   X     X     X
XXX X XXXXX X XXX
X X X       X   X
X X X XXXXXXXXX X
X   X X     X   X
X XXX X XXX X X X
X X   X   X X X X
X XXXXXXX X X X X
X   X   X X   X X
XXX X X X XXXXX X
X X X X X   X X X
X X X X XXX X X X
X   X X   X X X X
X XXX XXX X X X X
X     X     X   X
XXXXXXXXXXXXXXXXX