XXXXXSXXXXXXXXXXX
F   X       X   X
XXX XXXXX XXX X X
X X     X X   X X
X XXXXX X X XXX X
X       X   X   X
X XXXXXXX XXX XXX
X     X X X X   X
XXXXX X X X XXX X
X   X X       X X
X XXX X XXXXXXX X
X     X X X     X
X XXXXX X X XXX X
X     X   X   X X
XXXXX XXXXXXX X X
X             X X
XXXXXXXXXXXXXXXXX