XSXXXXXXXXXXXXXXX
X X   X         X
X XXX X X XXXXXXX
X   X   X   X   X
XXX XXX XXX X X X
XFX   X   X   X X
X XXX XXXXXXX X X
X   X       X X X
X X XXXXXXX XXX X
X X   X   X     X
XXX X X X XXXXX X
X   X   X     X X
X X XXXXXXXXXXX X
X X X   X     X X
X XXX X X XXX X X
X     X     X   X
XXXXXXXXXXXXXXXXX